13BGH	symmetric	NA
13GS	symmetric	NA
2DDA7Ptm@CITtbm@DDPAm@E4Ptm	symmetric	NA
2DHPtm@DPRm@PANTtm	symmetric	NA
2HBO@2HBt2	symmetric	NA
2MBACt@OHACT3	symmetric	NA
2MBALDt	symmetric	NA
2MBALDtm@2MBTOHtm@ALCD22xim	symmetric	NA
2MBTOHt	symmetric	NA
2MPPALt	symmetric	NA
ACALDCD	symmetric	NA
ACALDt	symmetric	NA
ACALDtm	symmetric	NA
ACCOAC	symmetric	NA
AGAT_SC	symmetric	NA
AGPRim@ACGKm@ACOTAim@ORNTACim@ORNt3m	symmetric	NA
AGTi	unambiguous	0,0,0,0,1,1
2MPPALtm@ALCD23xim@IBUTOHtm	symmetric	NA
ACESt	symmetric	NA
AHCi	symmetric	NA
AHSERL2	symmetric	NA
2OBUTtm	symmetric	NA
2OXOADPtim@AATA@HCITSm@HACNHm@HICITDm@MCITDm@OXAGm@SACCD1@SACCD2	symmetric	NA
ACHBSm@DHAD2m@KARA2im	symmetric	NA
ACHLE1	symmetric	NA
2PHETOHt	symmetric	NA
ACHLE2	symmetric	NA
ACHLE3	symmetric	NA
ACLSm@DHAD1m@KARA1im	symmetric	NA
2PHETOHtm@ALCD25xim@PACALDtm	unambiguous	0,0,0,0,1,0
ACOAHim	symmetric	NA
AICART@IMPC	symmetric	NA
AIRCr@ADSL2r@GLUPRT@GARFT@PRAGSr@PRAIS@PRASCSi@PRFGS	symmetric	NA
AKGDam@AKGDbm@SUCOASm	symmetric	NA
AKGMAL	symmetric	NA
AKGt2r	symmetric	NA
ALATA_L	symmetric	NA
ALATA_Lm@ALAtmi	symmetric	NA
34HPPt2m@TYRTAim@TYRt2m	symmetric	NA
ALAt2r	symmetric	NA
ACONT	symmetric	NA
ACONT3m@MCITL2m@MCITSm@OBDHm	symmetric	NA
ACONTm	symmetric	NA
ALCD22xi	symmetric	NA
ALCD22yi	symmetric	NA
ALCD23xi	symmetric	NA
ALCD23yi	symmetric	NA
ALCD24xi	unambiguous	1,1,0,1,0,0
ALCD24xim@3MBALDtm@IAMOHtm	unambiguous	0,0,0,0,1,0
ACPSm@DPCOAK@PAN4Ptm@PAPtm@PTPATi	symmetric	NA
ACRNtm@CRNtim	symmetric	NA
ACS	symmetric	NA
ACSm	symmetric	NA
ACt2r	symmetric	NA
ALCD24yi	symmetric	NA
ALCD25xi	unambiguous	0,1,0,0,0,1
ALCD25yi	symmetric	NA
ACtm	symmetric	NA
3C3HMPt	symmetric	NA
ACtr	ambiguous	NA
ADA	ambiguous	NA
ADCL@ADCS@4ABZt	symmetric	NA
ALCD26xi	symmetric	NA
ALCD26xim@IND3ETHtm@ID3ACALDtm	symmetric	NA
ALCD2x_copy1	symmetric	NA
ALCD2ir	symmetric	NA
ALCD2irm@ETOHtm	symmetric	NA
3C3HMPtm@IPPSm	symmetric	NA
ADD	symmetric	NA
ADEt2	symmetric	NA
ADHAPR_SC@GAT2_SC	symmetric	NA
ADK1	unambiguous	1,1,1,1,0,1
ADK1m	symmetric	NA
ADK3	symmetric	NA
ALCD2x_copy2	symmetric	NA
ALDD22x@MOHMT@PANTS@PNTOt2	symmetric	NA
ALDD2xm	symmetric	NA
ALDD2y	symmetric	NA
ALDD2ym	symmetric	NA
ADK3m@GTPt2m	symmetric	NA
ADK4@NDPK9	symmetric	NA
ADMDC@DKMPPD2@MDRPD@MTAP@MTRI@UNK3	symmetric	NA
ADNCYC@PDE1	symmetric	NA
ADNK1	unambiguous	1,1,1,1,0,1
ADNUC	symmetric	NA
ADPT	symmetric	NA
ADSK@PAPSR	symmetric	NA
ALPHNH@UREASE	symmetric	NA
ADSL1r@ADSS	symmetric	NA
AMPN	symmetric	NA
AMPDA	unambiguous	0,0,0,0,1,0
ANPRT@IGPS@PRAIi@TRPS1	symmetric	NA
ATPtm_H	symmetric	NA
ANS	symmetric	NA
AP4AH@ATPATF1	symmetric	NA
APRTO2@AABTN@NABTNO@POLYAO	symmetric	NA
3HAO@HKYNH@KYN3OX@QUILSYN	symmetric	NA
ARGN	unambiguous	1,1,0,1,1,1
BPNT	symmetric	NA
BTDD_RR@BTDt_RR	symmetric	NA
C14STR@C3STDH1@C3STDH2@C3STKR1@C3STKR2@C4STMO1@C4STMO2	symmetric	NA
C22STDS	symmetric	NA
C22STDSx	symmetric	NA
C24STRer@ERGSTter@ERGTETROLter	symmetric	NA
ARGSL@ARGSS@OCBT	symmetric	NA
ARGt2r	symmetric	NA
ASAD	symmetric	NA
ASNN	unambiguous	1,1,1,0,1,0
ASNNe	symmetric	NA
ASNS1	symmetric	NA
3MBALDt	symmetric	NA
C5STDS	symmetric	NA
C8STI	symmetric	NA
ASNt2r	symmetric	NA
ASNt6@ASNt7	symmetric	NA
CAT	symmetric	NA
ASPCT@DHORTS@OMPDC@ORPT	symmetric	NA
3MOBDC	symmetric	NA
ASPGLU2m	symmetric	NA
ASPK	symmetric	NA
ASPOcm@QULNS	symmetric	NA
CBPS	symmetric	NA
ASPTA	unambiguous	1,1,1,1,1,0
ASPTAm	symmetric	NA
3MOBtm	symmetric	NA
ASPt2m	symmetric	NA
ASPt2n@ASPt5n@CO2tn@H2Otn@HCO3En@HCO3tn	symmetric	NA
CERASE124er	symmetric	NA
3MOPDC	symmetric	NA
CERASE126er	symmetric	NA
ASPt2r	symmetric	NA
CERASE224er	symmetric	NA
CERASE226er	symmetric	NA
3MOPt	symmetric	NA
ATPH1	symmetric	NA
ATPM	symmetric	NA
CERS124er	symmetric	NA
CERS126er	symmetric	NA
CERS224er	symmetric	NA
ATPPRT@HISTD@HISTP@HSTPT@IG3PS@IGPDH@PRAMPC@PRATPP@PRMICI	unambiguous	0,1,0,0,0,0
ATPS	symmetric	NA
ATPS3m	symmetric	NA
CERS226er	symmetric	NA
3MOPtm	symmetric	NA
CITtcm	symmetric	NA
CHLPCTD@CHOLK@DAGCPT_SC	symmetric	NA
CHLSTI	symmetric	NA
CMPN	symmetric	NA
CHORM	symmetric	NA
CHORS@DHQS@DHQTi@SHK3Dr@SHKK@PSCVT	symmetric	NA
CO2t	symmetric	NA
CO2tm	symmetric	NA
CITt2r	symmetric	NA
CO2tv@PEtv_SC@PSERDv_SC@PStv_SC	symmetric	NA
COAtim	symmetric	NA
CITtam	symmetric	NA
CRNCARtm	symmetric	NA
DCTPD	symmetric	NA
DCYTD@NTD3	symmetric	NA
CSNATm@CSNATr	symmetric	NA
DDPA	symmetric	NA
DESAT16	symmetric	NA
DESAT18	symmetric	NA
CSND	unambiguous	1,0,1,1,1,1
CSNt2	unambiguous	1,0,1,1,1,1
CSm	symmetric	NA
DESAT18_2@DOLPMMer@DB4PS@DOLPMTcer@DOLPt2er@DROPPRy@DRTPPD@GTPCII@MAN1PT@MAN6PI@MANNANter@MI1PS@PMAN	symmetric	NA
DGK1	symmetric	NA
CTPS1	symmetric	NA
CTPS2	symmetric	NA
CTPtm@DASYNm_SC@PAtm_SC@PSERSm_SC	unambiguous	0,0,0,0,1,1
DHAK@GLYCDy	symmetric	NA
CYOOm@O2tm	symmetric	NA
CYOR_u6m	symmetric	NA
DHAPtm@GLYC3Ptm	symmetric	NA
DHFR@TMDS	unambiguous	1,0,1,0,0,1
CYSS@SERAT	symmetric	NA
CYSTGL	symmetric	NA
CYSTL	symmetric	NA
CYSTS	symmetric	NA
DHORD4i	symmetric	NA
DHORDfum	symmetric	NA
CYSt2r	symmetric	NA
CYTD	symmetric	NA
CYTDK2	symmetric	NA
DHORDi	symmetric	NA
CYTK1	symmetric	NA
CYTK2	symmetric	NA
DADA@PUNP6	ambiguous	NA
DADK	symmetric	NA
DIAT@POLYAO2	symmetric	NA
DAGPYP_SC	symmetric	NA
DMATT	symmetric	NA
DASYN_SC	symmetric	NA
DCMPDA	symmetric	NA
4HGLSDm@PHCDm@PHCHGSm	symmetric	NA
DPMVD	symmetric	NA
DPR	symmetric	NA
ENO@PGM	symmetric	NA
DTMPK@DTTPt@NDPK4	symmetric	NA
DURIK1	symmetric	NA
DURIPP	symmetric	NA
DUTPDP	symmetric	NA
EPISTt	symmetric	NA
D_LACDcm	unambiguous	0,0,1,0,1,1
4MOPDC	symmetric	NA
D_LACDm	symmetric	NA
D_LACt2	symmetric	NA
D_LACt2m	symmetric	NA
D_LACtm	symmetric	NA
ERGSTt	symmetric	NA
ETOHt	symmetric	NA
6PGLter@G6PDH2er@G6Pter	symmetric	NA
AASAD1	symmetric	NA
AASAD2	symmetric	NA
ABTA@SSALy	symmetric	NA
ABUTt2r	symmetric	NA
ACACT1r@HMGCOAS	symmetric	NA
ACACT1m@HMGCOASm@HMGCOAtm	symmetric	NA
FACOAL161	symmetric	NA
FACOAL180	symmetric	NA
FACOAL181	symmetric	NA
FACOAL182	symmetric	NA
FAS180	symmetric	NA
FAS100@FAS80_L	symmetric	NA
FAS100COA@FAS80COA_L	symmetric	NA
FAS120	symmetric	NA
FAS120COA	symmetric	NA
FAS140	symmetric	NA
FAS140COA	symmetric	NA
FACOAL140	symmetric	NA
FAS160	symmetric	NA
FAS160COA	symmetric	NA
FAS161	symmetric	NA
FACOAL160	symmetric	NA
G3PDm	symmetric	NA
FAS180COA	symmetric	NA
GLUK	symmetric	NA
FAS181	symmetric	NA
G3PT	symmetric	NA
G5SADs@P5CR	symmetric	NA
G5SADrm@PYR5CDm	symmetric	NA
G5SD	symmetric	NA
G5SD2	symmetric	NA
GLUN	symmetric	NA
G6PDA	symmetric	NA
G6PDH2r	unambiguous	0,1,1,1,1,1
G6PI	symmetric	NA
G6PI3	symmetric	NA
GALT@UGLT	symmetric	NA
GLUSx	symmetric	NA
GLUt2r	symmetric	NA
GLUt5m@PIt5m	symmetric	NA
GLUt7m	symmetric	NA
GLXt	symmetric	NA
GALUi	symmetric	NA
GAM6Pt	symmetric	NA
GAPD@PGK	symmetric	NA
GLYCLm	symmetric	NA
GLYCt	symmetric	NA
GLYCt2	symmetric	NA
GAT1_SC	symmetric	NA
GBEZ@GLYGS	symmetric	NA
GCC2am@GCC2bim	symmetric	NA
GCC2cm_copy1	symmetric	NA
GCCam@GCCbim@GCCcm	symmetric	NA
GLYK	symmetric	NA
GLYOX	symmetric	NA
GLYt2m@GHMT2rm	symmetric	NA
GLYt2r	symmetric	NA
GMPS2	symmetric	NA
GND@PGL	symmetric	NA
GNNUC	symmetric	NA
GF6PTA	symmetric	NA
GPDDA1	symmetric	NA
FBA	symmetric	NA
GHMT2r	unambiguous	1,1,1,0,0,1
GRTT	symmetric	NA
GSNK	symmetric	NA
GK1	symmetric	NA
GK2	ambiguous	NA
GLCGSD	unambiguous	0,1,1,0,0,0
GLCGSDv@GLCNtv	symmetric	NA
GTHOr	symmetric	NA
GLCP	unambiguous	1,0,0,1,0,1
GLCS2	symmetric	NA
GTHPi	symmetric	NA
GLCt1	symmetric	NA
GLCtv	symmetric	NA
FBA3@PFK_3	symmetric	NA
GLNS	unambiguous	0,0,1,0,1,1
FBP	symmetric	NA
GLNt2r	symmetric	NA
GLNt6@GLNt7	symmetric	NA
GTPH1	symmetric	NA
FBP26@PFK26	symmetric	NA
GLU5K	symmetric	NA
GLUDC	symmetric	NA
GUAD	symmetric	NA
GUAPRT	symmetric	NA
GUAt2r	symmetric	NA
H2Ot	symmetric	NA
GLUDxi	symmetric	NA
GLUDy	symmetric	NA
H2Oter@HMGCOAR@LNSTLS@O2ter@PMEVK@SQ23EPXter@SQLEr@SQLS@SQLter	symmetric	NA
H2Otm	symmetric	NA
H2Otv	unambiguous	1,1,1,1,0,1
FDH	symmetric	NA
FDNG	symmetric	NA
HCO3E	symmetric	NA
FE2utm@FEtm	symmetric	NA
HCYSMT	symmetric	NA
HETZK@HMPK1@PMPK@TMN@TMPPP	symmetric	NA
HEX1	symmetric	NA
HEX7@SBTD_D2	symmetric	NA
ILEtmi@ILETAm	symmetric	NA
FECOSTt	symmetric	NA
FKYNH@TRPO2	symmetric	NA
IMPD	symmetric	NA
IND3ETHt	symmetric	NA
INDPYRD@TRPTA	symmetric	NA
INSK	unambiguous	0,0,0,0,1,0
HISt2r	symmetric	NA
IPC124PLC_SC@IPCS124_SC	symmetric	NA
IPC126PLC_SC@IPCS126_SC	symmetric	NA
IPC224PLC_SC@IPCS224_SC	symmetric	NA
IPC226PLC_SC@IPCS226_SC	symmetric	NA
IPC324PLC_SC@IPCS324_SC	symmetric	NA
IPC326PLC_SC@IPCS326_SC	symmetric	NA
HSDxi	symmetric	NA
IPDDI	symmetric	NA
IPMD@IPPMIa@IPPMIb@OMCDC	symmetric	NA
IPPS	symmetric	NA
HSDy	symmetric	NA
HSERTA	symmetric	NA
HSK@THRS	symmetric	NA
HXANt2r	symmetric	NA
HXPRT	symmetric	NA
HYPOE@PYDAMK	symmetric	NA
IAMACt	symmetric	NA
IAMOHt	symmetric	NA
IBUTACt	symmetric	NA
IBUTOHt	symmetric	NA
ICDHxm	symmetric	NA
KYN	symmetric	NA
LALDO3@LCADi	symmetric	NA
ICDHyr	unambiguous	1,1,1,1,1,0
ICDHym	unambiguous	1,0,0,1,0,1
ICL	unambiguous	0,0,0,0,1,1
LANOSTt	symmetric	NA
LEUTA	symmetric	NA
ID3ACALDt	symmetric	NA
ILETA	symmetric	NA
ILEt2r	symmetric	NA
ILEt6@ILEt7	unambiguous	1,0,0,0,0,0
LEUt2r	symmetric	NA
LEUt6@LEUt7	symmetric	NA
LGTHL	symmetric	NA
LNS14DM	symmetric	NA
LNS14DMx	symmetric	NA
FORt	symmetric	NA
LPCAT_SC@PCDAGAT	symmetric	NA
LPP_SC@PAK_SC	symmetric	NA
FRDcm	unambiguous	1,1,1,1,0,0
LYSt2r	symmetric	NA
MALS	symmetric	NA
MALt2r	symmetric	NA
MALtm	symmetric	NA
L_LACD2cm	symmetric	NA
L_LACt2r	symmetric	NA
FRDm	symmetric	NA
MDH	symmetric	NA
MDHm	symmetric	NA
ME1m	unambiguous	1,1,0,0,1,0
ME2m	unambiguous	0,0,1,1,0,1
FTHFCLm@THFATm	symmetric	NA
METAT	symmetric	NA
MTHFC	unambiguous	1,1,1,0,0,1
MTHFD	unambiguous	1,1,1,0,0,1
MTHFD2i	symmetric	NA
MTHFR3@METS	unambiguous	0,0,0,0,1,0
METB1	symmetric	NA
FTHFLi	unambiguous	0,0,0,0,1,0
METt2r	symmetric	NA
NADH2_u6cm	ambiguous	NA
NADH2_u6m	symmetric	NA
NADK	symmetric	NA
MEVK1	symmetric	NA
MEVK2	symmetric	NA
MEVK3	symmetric	NA
MEVK4	symmetric	NA
MFAPS_SC@PETOHM_SC@PMETM_SC	symmetric	NA
MGSA	symmetric	NA
NADKm@NADPPPSm	symmetric	NA
NADPPPS	symmetric	NA
NADPt@NADS1@NNATr@NNDPR	symmetric	NA
FUM	symmetric	NA
MI1PP@PINOS_SC	symmetric	NA
NDP1	symmetric	NA
NDP3	symmetric	NA
NDP4	symmetric	NA
NDP7	symmetric	NA
FUMm	symmetric	NA
NDPK1	symmetric	NA
NDPK2	symmetric	NA
NDPK3	symmetric	NA
NDPK5	symmetric	NA
NDPK6	symmetric	NA
FUMt2r	symmetric	NA
NDPK7	symmetric	NA
NDPK8	symmetric	NA
NFORTYRt@NFTYROX@TYRNFT	unambiguous	1,1,1,0,0,1
NH4t	symmetric	NA
NH4ti	symmetric	NA
NH4tm	symmetric	NA
NTD1	unambiguous	0,0,0,1,0,0
NTD10@PUNP7	symmetric	NA
NTD11	symmetric	NA
NTD2	symmetric	NA
NTD4	symmetric	NA
NTD5	symmetric	NA
NTD6	symmetric	NA
NTD7	symmetric	NA
NTD8@PUNP4	symmetric	NA
NTD9	symmetric	NA
NTP3	symmetric	NA
G3PCt	symmetric	NA
G3PD1ir	symmetric	NA
NTP4	symmetric	NA
G3PD1irm	symmetric	NA
O2t	symmetric	NA
OAAt	symmetric	NA
PEtm_SC@PSERDm_SC	symmetric	NA
OAAt2m	unambiguous	0,0,0,0,1,0
PPM	symmetric	NA
OHACT1	symmetric	NA
PFK	symmetric	NA
OHACT2	symmetric	NA
PGCD@PSERT@PSP_L	symmetric	NA
PGI	symmetric	NA
OHACT4	symmetric	NA
PGMT	symmetric	NA
OHACT5@PHEACt	symmetric	NA
ORNDC	symmetric	NA
PPND	symmetric	NA
ORNTA	symmetric	NA
ORNt2r	symmetric	NA
PHETA1	unambiguous	0,1,0,0,1,1
PHEt2r	symmetric	NA
PI35BP5P_SC@PI3P5K_SC	symmetric	NA
PPND2	symmetric	NA
P5CDm	unambiguous	1,1,1,0,1,0
PPNDH	symmetric	NA
PACALDt	symmetric	NA
PI45BP5P_SC@PI4P5K_SC	symmetric	NA
PIt2m	symmetric	NA
PAPt	symmetric	NA
PIt2r	symmetric	NA
PC	symmetric	NA
PLBPC_SC	symmetric	NA
PLD_SC	symmetric	NA
PMDPHT	symmetric	NA
GCC2cm_copy2	ambiguous	NA
PDHm	symmetric	NA
PMI12346PH@PMI12346PS	symmetric	NA
PMI1346PH@PMI1346PS	symmetric	NA
PPYRDC	unambiguous	0,1,0,0,1,1
PYRDC2	symmetric	NA
PYRt	symmetric	NA
POLYAO3	symmetric	NA
PYRt2	symmetric	NA
PYRt2m	symmetric	NA
PPA	symmetric	NA
PPAm	unambiguous	0,0,0,0,1,1
PPCK	symmetric	NA
SLFAT	symmetric	NA
RBFSa	symmetric	NA
RBFSb	symmetric	NA
SO3ti	symmetric	NA
SO4ti	symmetric	NA
RBK	symmetric	NA
SPMDAT1	symmetric	NA
RNDR1	ambiguous	NA
SPMDt3i	symmetric	NA
SPMDtex2	symmetric	NA
RNDR2	symmetric	NA
RNDR3	symmetric	NA
SPMS	symmetric	NA
SPRMS	symmetric	NA
RNDR4	symmetric	NA
PRO1xm@PROtm	unambiguous	1,1,1,0,1,1
RNTR1	symmetric	NA
RNTR2	symmetric	NA
RNTR3	symmetric	NA
RNTR4	symmetric	NA
RPE	symmetric	NA
PROt2r	symmetric	NA
RPI	symmetric	NA
SUCCt2r	symmetric	NA
SADT	symmetric	NA
SAM24MT	symmetric	NA
SUCCtm	symmetric	NA
SUCD1m	ambiguous	NA
SUCD2_u6m	symmetric	NA
SUCD3_u6m	unambiguous	0,0,0,0,0,1
SUCFUMtm	symmetric	NA
SBTR	symmetric	NA
SBT_Dt	symmetric	NA
SULR	symmetric	NA
PRPPS	unambiguous	0,1,0,0,0,0
SERt2m	symmetric	NA
SERt2r	symmetric	NA
TAGL_SC	symmetric	NA
TALA	symmetric	NA
SHSL1@SHSL4r	symmetric	NA
THIORDXi	symmetric	NA
THMP	symmetric	NA
THRt2r	symmetric	NA
THYMt3r@TMDPP	symmetric	NA
TKT1	symmetric	NA
TKT2	symmetric	NA
TMDK1	unambiguous	0,1,0,1,1,0
TMDPK@TMPK	symmetric	NA
THRA	symmetric	NA
THRD_L	symmetric	NA
THRD_Lm@THRt2m	symmetric	NA
URIK1	symmetric	NA
TPI	symmetric	NA
TRDR	symmetric	NA
TRE6PP@TRE6PS	symmetric	NA
URIK2	symmetric	NA
UTPH1	symmetric	NA
TREH	symmetric	NA
PSERS_SC	unambiguous	1,1,1,1,0,0
TREHv@TREt2v	unambiguous	1,1,1,1,0,1
VALTA	unambiguous	1,1,0,1,1,1
VALTAim@VALt2m	symmetric	NA
TREt2	symmetric	NA
VALt2r	symmetric	NA
XANt	symmetric	NA
XPPT	symmetric	NA
TRIGS_SC	ambiguous	NA
TRPt2r	symmetric	NA
TTDCAtr	symmetric	NA
TYRTAi	symmetric	NA
TYRt2r	symmetric	NA
TYRt6@TYRt7	unambiguous	0,1,1,1,0,1
ZYMSTt	symmetric	NA
BIOMASS_SC5_notrace	symmetric	NA
SERD_L	ambiguous	NA
UMPK	symmetric	NA
PStm_SC	symmetric	NA
UPPRT	symmetric	NA
URAt2	ambiguous	NA
UREA2t2	symmetric	NA
URIDK2r	symmetric	NA
PTRCt3i	symmetric	NA
PTRCtex2	symmetric	NA
PUNP1	symmetric	NA
PUNP2	symmetric	NA
PUNP3	symmetric	NA
PUNP5	ambiguous	NA
PYK	symmetric	NA
PYNP2r	symmetric	NA
PYRDC	symmetric	NA
EX_zymst_e	symmetric	NA
EX_pyr_e	symmetric	NA
EX_ptrc_e	symmetric	NA
EX_pro__L_e	symmetric	NA
EX_xan_e	symmetric	NA
EX_val__L_e	symmetric	NA
EX_urea_e	unambiguous	1,1,0,1,1,1
EX_ura_e	symmetric	NA
EX_tyr__L_e	symmetric	NA
EX_ttdca_e	symmetric	NA
EX_pnto__R_e	symmetric	NA
EX_pi_e	symmetric	NA
EX_pheac_e	symmetric	NA
EX_phe__L_e	symmetric	NA
EX_trp__L_e	symmetric	NA
EX_tre_e	symmetric	NA
EX_pap_e	symmetric	NA
EX_pacald_e	symmetric	NA
EX_thym_e	symmetric	NA
EX_thr__L_e	symmetric	NA
EX_orn_e	unambiguous	1,1,0,1,1,1
EX_oaa_e	symmetric	NA
EX_o2_e	symmetric	NA
EX_nh4_e	symmetric	NA
EX_nadp_e	symmetric	NA
EX_succ_e	symmetric	NA
EX_spmd_e	symmetric	NA
EX_so4_e	symmetric	NA
EX_so3_e	symmetric	NA
EX_ser__L_e	symmetric	NA
EX_met__L_e	symmetric	NA
EX_sbt__D_e	symmetric	NA
EX_mal__L_e	symmetric	NA
EX_lys__L_e	symmetric	NA
EX_leu__L_e	symmetric	NA
EX_dttp_e	symmetric	NA
EX_lanost_e	symmetric	NA
EX_lac__L_e	symmetric	NA
EX_lac__D_e	unambiguous	1,1,0,1,0,0
EX_ind3eth_e	symmetric	NA
EX_ile__L_e	symmetric	NA
EX_id3acald_e	symmetric	NA
EX_ibutoh_e	symmetric	NA
EX_cys__L_e	symmetric	NA
EX_csn_e	symmetric	NA
EX_co2_e	symmetric	NA
EX_cit_e	symmetric	NA
EX_ibutac_e	symmetric	NA
EX_iamoh_e	symmetric	NA
EX_iamac_e	symmetric	NA
EX_hxan_e	unambiguous	1,0,1,1,0,0
EX_his__L_e	symmetric	NA
EX_btd_RR_e	symmetric	NA
EX_asp__L_e	symmetric	NA
EX_asn__L_e	symmetric	NA
EX_h_e	symmetric	NA
EX_h2o_e	symmetric	NA
EX_arg__L_e	symmetric	NA
EX_gua_e	symmetric	NA
EX_glyc_e	symmetric	NA
EX_gly_e	symmetric	NA
EX_ala__L_e	symmetric	NA
EX_akg_e	symmetric	NA
EX_ade_e	symmetric	NA
EX_glx_e	symmetric	NA
EX_glu__L_e	symmetric	NA
EX_gln__L_e	symmetric	NA
EX_glc__D_e	symmetric	NA
EX_gam6p_e	symmetric	NA
EX_aces_e	symmetric	NA
EX_acald_e	symmetric	NA
EX_ac_e	symmetric	NA
EX_Nbfortyr_e	unambiguous	1,1,1,0,0,1
EX_4abz_e	symmetric	NA
EX_g3pc_e	symmetric	NA
EX_fum_e	symmetric	NA
EX_4abut_e	symmetric	NA
EX_3mop_e	symmetric	NA
EX_for_e	unambiguous	1,1,1,1,0,1
EX_3mbald_e	symmetric	NA
EX_3c3hmp_e	symmetric	NA
EX_2phetoh_e	unambiguous	0,1,0,0,1,1
EX_2mppal_e	symmetric	NA
EX_2mbtoh_e	symmetric	NA
EX_2mbald_e	symmetric	NA
EX_2mbac_e	symmetric	NA
EX_fecost_e	symmetric	NA
EX_etoh_e	symmetric	NA
EX_2hb_e	symmetric	NA
EX_ergst_e	symmetric	NA
EX_epist_e	symmetric	NA
2HBO@2HBt2_rev	symmetric	NA
ACALDt_rev	symmetric	NA
ACALDtm_rev	symmetric	NA
2OBUTtm_rev	symmetric	NA
2PHETOHt_rev	unambiguous	0,1,0,0,1,1
AICART@IMPC_rev	unambiguous	0,1,0,0,0,0
AKGMAL_rev	symmetric	NA
AKGt2r_rev	symmetric	NA
ALATA_L_rev	unambiguous	1,0,1,0,0,1
ALAt2r_rev	symmetric	NA
ACt2r_rev	unambiguous	0,1,0,0,0,1
ACtm_rev	symmetric	NA
ACtr_rev	ambiguous	NA
ADK1_rev	symmetric	NA
ADK1m_rev	symmetric	NA
ADK3_rev	symmetric	NA
ALCD2x_copy2_rev	symmetric	NA
BTDD_RR@BTDt_RR_rev	symmetric	NA
ARGt2r_rev	symmetric	NA
ASAD_rev	symmetric	NA
ASNt2r_rev	symmetric	NA
ASPTA_rev	symmetric	NA
ASPTAm_rev	symmetric	NA
3MOBtm_rev	symmetric	NA
ASPt2m_rev	symmetric	NA
ASPt2n@ASPt5n@CO2tn@H2Otn@HCO3En@HCO3tn_rev	symmetric	NA
ASPt2r_rev	symmetric	NA
3MOPt_rev	symmetric	NA
3MOPtm_rev	symmetric	NA
CITtcm_rev	ambiguous	NA
CO2t_rev	symmetric	NA
CO2tm_rev	symmetric	NA
CITt2r_rev	symmetric	NA
CITtam_rev	symmetric	NA
DGK1_rev	symmetric	NA
CYSt2r_rev	symmetric	NA
CYTK1_rev	symmetric	NA
CYTK2_rev	symmetric	NA
DADK_rev	symmetric	NA
DASYN_SC_rev	symmetric	NA
DCMPDA_rev	symmetric	NA
4HGLSDm@PHCDm@PHCHGSm_rev	symmetric	NA
ENO@PGM_rev	symmetric	NA
DTMPK@DTTPt@NDPK4_rev	symmetric	NA
DURIPP_rev	symmetric	NA
EPISTt_rev	symmetric	NA
D_LACt2_rev	unambiguous	1,1,0,1,0,0
D_LACt2m_rev	symmetric	NA
D_LACtm_rev	symmetric	NA
ERGSTt_rev	symmetric	NA
ETOHt_rev	symmetric	NA
ABUTt2r_rev	symmetric	NA
FACOAL140_rev	symmetric	NA
FACOAL160_rev	symmetric	NA
G6PI_rev	symmetric	NA
G6PI3_rev	symmetric	NA
GALT@UGLT_rev	symmetric	NA
GLUt2r_rev	symmetric	NA
GAM6Pt_rev	symmetric	NA
GAPD@PGK_rev	symmetric	NA
GLYt2m@GHMT2rm_rev	symmetric	NA
GLYt2r_rev	symmetric	NA
FBA_rev	symmetric	NA
GHMT2r_rev	symmetric	NA
GK1_rev	symmetric	NA
GK2_rev	symmetric	NA
GLCtv_rev	unambiguous	1,1,1,1,0,1
GLNt2r_rev	symmetric	NA
GUAt2r_rev	symmetric	NA
H2Ot_rev	symmetric	NA
GLUDy_rev	symmetric	NA
H2Otm_rev	symmetric	NA
FE2utm@FEtm_rev	symmetric	NA
FECOSTt_rev	symmetric	NA
HISt2r_rev	symmetric	NA
HSDy_rev	symmetric	NA
HXANt2r_rev	unambiguous	1,0,1,1,0,0
LANOSTt_rev	symmetric	NA
LEUTA_rev	symmetric	NA
ILETA_rev	symmetric	NA
ILEt2r_rev	symmetric	NA
LEUt2r_rev	symmetric	NA
FORt_rev	unambiguous	1,1,1,1,0,1
LYSt2r_rev	symmetric	NA
MALt2r_rev	symmetric	NA
MALtm_rev	symmetric	NA
L_LACt2r_rev	symmetric	NA
MDH_rev	unambiguous	1,1,1,1,0,1
MDHm_rev	symmetric	NA
MTHFC_rev	symmetric	NA
MTHFD_rev	ambiguous	NA
METt2r_rev	symmetric	NA
FUM_rev	unambiguous	0,0,1,0,0,0
NDPK1_rev	symmetric	NA
NDPK3_rev	symmetric	NA
NDPK5_rev	symmetric	NA
NDPK6_rev	symmetric	NA
FUMt2r_rev	symmetric	NA
NDPK7_rev	symmetric	NA
NDPK8_rev	symmetric	NA
NH4t_rev	symmetric	NA
NH4tm_rev	symmetric	NA
G3PCt_rev	symmetric	NA
OAAt2m_rev	symmetric	NA
PPM_rev	symmetric	NA
PGI_rev	symmetric	NA
PGMT_rev	symmetric	NA
ORNt2r_rev	unambiguous	1,1,0,1,1,1
PHETA1_rev	symmetric	NA
PHEt2r_rev	symmetric	NA
PIt2m_rev	symmetric	NA
PAPt_rev	symmetric	NA
PYRt2m_rev	symmetric	NA
SLFAT_rev	symmetric	NA
RPE_rev	symmetric	NA
PROt2r_rev	symmetric	NA
RPI_rev	symmetric	NA
SUCCt2r_rev	symmetric	NA
SUCD1m_rev	symmetric	NA
SUCD2_u6m_rev	symmetric	NA
SUCD3_u6m_rev	symmetric	NA
SBT_Dt_rev	symmetric	NA
SERt2m_rev	symmetric	NA
SERt2r_rev	symmetric	NA
TALA_rev	symmetric	NA
THRt2r_rev	symmetric	NA
THYMt3r@TMDPP_rev	symmetric	NA
TKT1_rev	symmetric	NA
TKT2_rev	symmetric	NA
TPI_rev	symmetric	NA
PSERS_SC_rev	symmetric	NA
VALTA_rev	symmetric	NA
VALt2r_rev	symmetric	NA
XANt_rev	symmetric	NA
TRPt2r_rev	symmetric	NA
TTDCAtr_rev	symmetric	NA
TYRt2r_rev	symmetric	NA
ZYMSTt_rev	symmetric	NA
PStm_SC_rev	symmetric	NA
UREA2t2_rev	unambiguous	1,1,0,1,1,1
URIDK2r_rev	symmetric	NA
PUNP1_rev	symmetric	NA
PUNP2_rev	symmetric	NA
PUNP3_rev	symmetric	NA
PUNP5_rev	symmetric	NA
PYNP2r_rev	symmetric	NA
EX_pro__L_e_rev	symmetric	NA
EX_val__L_e_rev	symmetric	NA
EX_ura_e_rev	ambiguous	NA
EX_tyr__L_e_rev	symmetric	NA
EX_pi_e_rev	symmetric	NA
EX_phe__L_e_rev	symmetric	NA
EX_trp__L_e_rev	symmetric	NA
EX_tre_e_rev	symmetric	NA
EX_thym_e_rev	ambiguous	NA
EX_thr__L_e_rev	symmetric	NA
EX_o2_e_rev	symmetric	NA
EX_nh4_e_rev	symmetric	NA
EX_so4_e_rev	symmetric	NA
EX_ser__L_e_rev	symmetric	NA
EX_met__L_e_rev	symmetric	NA
EX_lys__L_e_rev	symmetric	NA
EX_leu__L_e_rev	symmetric	NA
EX_ile__L_e_rev	symmetric	NA
EX_cys__L_e_rev	symmetric	NA
EX_csn_e_rev	unambiguous	1,0,1,1,1,1
EX_his__L_e_rev	symmetric	NA
EX_asp__L_e_rev	symmetric	NA
EX_asn__L_e_rev	symmetric	NA
EX_h_e_rev	symmetric	NA
EX_h2o_e_rev	symmetric	NA
EX_arg__L_e_rev	symmetric	NA
EX_gua_e_rev	symmetric	NA
EX_gly_e_rev	symmetric	NA
EX_ala__L_e_rev	symmetric	NA
EX_ade_e_rev	symmetric	NA
EX_glu__L_e_rev	symmetric	NA
EX_gln__L_e_rev	symmetric	NA
EX_glc__D_e_rev	symmetric	NA
